R      500 500             


SO       ./textures/purplestone.png       

WE      ./textures/redbrick.png       

EA               ./textures/greystone.png        
NO          ./textures/mossy.png       


S           ./textures/barrel.png        

F           6,120,2         
C                 1,141,255        

        11111111111111
        10000000000001
        10000000200001
        100E0020000001
        10000000200001
        10000000000001
1111111111111111111111